#library name
hexefx_audiolib_F32	KEYWORD1

AudioFilterAllpass	KEYWORD1
init	KEYWORD2
reset	KEYWORD2
process	KEYWORD2
coeff	KEYWORD2

AudioBasicDelay	KEYWORD1
getTap	KEYWORD2
write_toOffset	KEYWORD2
updateIndex	KEYWORD2

AudioBasicLfo	KEYWORD1
update	KEYWORD2
get	KEYWORD2
setRate	KEYWORD2
setDepth	KEYWORD2

AudioBasicPitch	KEYWORD1
setPitch	KEYWORD2
setPitchSemintone	KEYWORD2
setTone	KEYWORD2
setMix	KEYWORD2

AudioFilterShelvingLPHP	KEYWORD1
AudioFilterLP	KEYWORD1

mix_pwr	KEYWORD2
map_sat	KEYWORD1

AudioEffectPlateReverb_i16	KEYWORD1
begin	KEYWORD2
size	KEYWORD2
size_get	KEYWORD2
hidamp	KEYWORD2
lodamp	KEYWORD2
lowpass	KEYWORD2
hipass	KEYWORD2
diffusion	KEYWORD2
freeze	KEYWORD2
freezeBleedIn	KEYWORD2
wet_level	KEYWORD2
dry_level	KEYWORD2
freeze_tgl	KEYWORD2
freeze_get	KEYWORD2
chorus	KEYWORD2
shimmer	KEYWORD2
shimmerPitch	KEYWORD2
shimmerPitchSemitones	KEYWORD2
pitchSemitones	KEYWORD2
pitchMix	KEYWORD2

AudioEffectSpringReverb_i16	KEYWORD1
time	KEYWORD2
treble_cut	KEYWORD2
bass_cut	KEYWORD2

AudioEffectReverbSC_i16	KEYWORD1
feedback	KEYWORD2
bypass_setMode	KEYWORD2
bypass_geMode	KEYWORD2

AudioEffectDelayStereoi16	KEYWORD1
delay	KEYWORD2
feedback	KEYWORD2
inertia	KEYWORD2
mod_rateHz	KEYWORD2
mod_rate	KEYWORD2
mod_depth	KEYWORD2
tap_tempo	KEYWORD2

AudioMixerSynth8ch_i16	KEYWORD1
gainAll	KEYWORD2
gainModAll	KEYWORD2
gainMod	KEYWORD2
pan	KEYWORD2
panAll	KEYWORD2
panMod	KEYWORD2
panModAll	KEYWORD2
modEnable	KEYWORD2
modEnableAll	KEYWORD2
getGain	KEYWORD2
getPan	KEYWORD2
mixGain	KEYWORD2
mixPan	KEYWORD2
calc_gain	KEYWORD2

AudioSynthWaveform_ext_i16	KEYWORD1
AudioSynthWaveformModulated_ext_i16	KEYWORD1
pulseWidthSeq	KEYWORD2


